BATHROOM	B AE TH R UW M
EIGHT	EY T
ELEVATOR	EH L AH V EY T ER
EXIT	EH G Z IH T
EXIT(2)	EH K S AH T
FEEDBACK	F IY D B AE K
FIVE	F AY V
FOUR	F AO R
GO	G OW
GROVI	G R AA V IY
NAVIGATE	N AE V AH G EY T
NINE	N AY N
NORTH	N AO R TH
ONE	W AH N
ONE(2)	HH W AH N
SEVEN	S EH V AH N
SIX	S IH K S
SOUTH	S AW TH
STAIRS	S T EH R Z
STOP	S T AA P
THREE	TH R IY
TWO	T UW
WEST	W EH S T
ZERO	Z IY R OW
